111111111111111111111
1P0000000110000000001
101111100111101111101
1000C000000000000C001
101011111111110110101
1C010000C000001000001
101011101110111011101
100000100000000000001
101110111111111011101
1C000000C00000C0E00C1
111111111111111111111