1111111111111
1P00000000001
1111111111C11
1E10000000001
1111111111111