111111111111111111111111111111111111111111111111111111111111
1P00000000000000000000000000000000000000000000000000000000E1
100001111111111111111111111111111111111111111111111111100001
1C00010000000000000000000000000000000000000000000000000100C1
101110111111111111111111111111111111111111111111111111101101
100000000000000000000000000000000000000000000000000000000001
101111111111111111111111111111111111111111111111111111111101
100000000000000000000000000000000000000000000000000000000001
1C000C000C000C000C000C000C000C000C000C000C000C000C000C0000C1
101111101111101111101111101111101111101111101111101111101101
100000100000100000100000100000100000100000100000100000100001
101111111111111111111111111111111111111111111111111111111101
100000000000000000000000000000000000000000000000000000000001
1C000000C0000000C0000000C0000000C0000000C0000000C0000000C001
101010101010101010101010101010101010101010101010101010101101
100000000000000000000000000000000000000000000000000000000001
101111111111111111111111111111111111111111111111111111111101
100000000000000000000000000000000000000000000000000000000001
1C000C000C000C000C000C000C000C000C000C000C000C000C000C0000C1
101111101111101111101111101111101111101111101111101111101101
100000100000100000100000100000100000100000100000100000100001
101111111111111111111111111111111111111111111111111111111101
100000000000000000000000000000000000000000000000000000000001
1C000000C0000000C0000000C0000000C0000000C0000000C0000000C001
101010101010101010101010101010101010101010101010101010101101
1000000000000000000000000000000000000000000000000000000000M1
101111111111111111111111111111111111111111111111111111111101
100000000000000000000000000000000000000000000000000000000001
1C000C000C000C000C000C000C000C000C000C000C000C000C000C0000C1
101111101111101111101111101111101111101111101111101111101101
100000100000100000100000100000100000100000100000100000100001
111111111111111111111111111111111111111111111111111111111111